{
  "name": "streamline_map_navigation",
  "lineHeight": 0,
  "ascent": 0,
  "descent": 0,
  "boundingBox": {
    "width": 16,
    "height": 16,
    "xOffset": 0,
    "yOffset": 0
  },
  "glyphs": {
    "48": {
      "codePoint": 48,
      "width": 21,
      "height": 21,
      "xOffset": 0,
      "yOffset": 0,
      "xAdvance": 21,
      "bitmap": [
        "000000001111100000000",
        "000000110000011000000",
        "000011000000000110000",
        "000100000000000001000",
        "001000001000000000100",
        "001000001100000000100",
        "010000001110000000010",
        "010000001111000000010",
        "100000001011100000001",
        "100000001011110000001",
        "100000001011111000001",
        "100000001011111100001",
        "100000001111000000001",
        "010000001110000000010",
        "010000001100000000010",
        "001000001000000000100",
        "001000000000000000100",
        "000100000000000001000",
        "000011000000000110000",
        "000000110000011000000",
        "000000001111100000000"
      ]
    },
    "49": {
      "codePoint": 49,
      "width": 21,
      "height": 21,
      "xOffset": 0,
      "yOffset": 0,
      "xAdvance": 21,
      "bitmap": [
        "000000000010000000000",
        "000000000010000000000",
        "000000000010000000000",
        "000000001111100000000",
        "000000110000011000000",
        "000001000000000100000",
        "000010000111000010000",
        "000010011111110010000",
        "000100011111110001000",
        "000100111010111001000",
        "111100111111111001111",
        "000100110111011001000",
        "000100011000110001000",
        "000010011111110010000",
        "000010000111000010000",
        "000001000000000100000",
        "000000110000011000000",
        "000000001111100000000",
        "000000000010000000000",
        "000000000010000000000",
        "000000000010000000000"
      ]
    },
    "50": {
      "codePoint": 50,
      "width": 21,
      "height": 21,
      "xOffset": 0,
      "yOffset": 0,
      "xAdvance": 21,
      "bitmap": [
        "000000001111100000000",
        "000000110000011000000",
        "000001000000000100000",
        "000010000111000010000",
        "000010001110100010000",
        "000100011111010001000",
        "000100111111101001000",
        "000100111111101001000",
        "000100111111111001000",
        "000100011111110001000",
        "000010001111100010000",
        "000010000111000010000",
        "000010000000000010000",
        "000001000000000100000",
        "000001000000000100000",
        "000000100000001000000",
        "000000100000001000000",
        "000000010000010000000",
        "000000001000100000000",
        "000000000101000000000",
        "000000000010000000000"
      ]
    },
    "51": {
      "codePoint": 51,
      "width": 21,
      "height": 21,
      "xOffset": 0,
      "yOffset": 0,
      "xAdvance": 21,
      "bitmap": [
        "000000001111100000000",
        "000000110000011000000",
        "000001000000000100000",
        "000001000111000100000",
        "000010001110100010000",
        "000010011111010010000",
        "000010011111010010000",
        "000010011111110010000",
        "000010001111100010000",
        "000001000111000100000",
        "000001000000000100000",
        "000001000000000100000",
        "000000100000001000000",
        "000000100000001000000",
        "000000010000010000000",
        "000011010000010110000",
        "001100001000100001100",
        "010000000101000000010",
        "010000000010000000010",
        "001100000000000001100",
        "000011111111111110000"
      ]
    },
    "52": {
      "codePoint": 52,
      "width": 21,
      "height": 21,
      "xOffset": 0,
      "yOffset": 0,
      "xAdvance": 21,
      "bitmap": [
        "000111100000000000000",
        "001000010000000000000",
        "010011001000000000000",
        "100111100100000000000",
        "100111100100000000000",
        "100011000100000000000",
        "100000000100000000000",
        "010000001000001111000",
        "010000001000010000100",
        "001000010000100110010",
        "001000010001001111001",
        "000100100001001111001",
        "000011000001000110001",
        "000000000001000000001",
        "000010000000100000010",
        "000010000000100000010",
        "000000000000010000100",
        "000010000000010000100",
        "000010000000001001000",
        "000001101101100110000",
        "000000000000000000000"
      ]
    }
  }
}